挨	挨，捱
摆	擺，襬
板	板，闆
背	背，揹
辟	辟，闢
表	表，錶
别	別，彆
并	并，併，並
卜	卜，蔔
布	布，佈
彩	彩，綵
采	采，採
尝	嘗，嚐
冲	沖，衝
涌	涌，湧
丑	丑，醜
出	出，齣
掸	撣，撢
当	當，噹
荡	蕩，盪
吊	吊，弔
斗	斗，鬥
恶	惡，噁
发	發，髮
范	范，範
仿	仿，彷
丰	丰，豐
佛	佛，彿
复	復，複
干	干，乾，幹
杆	杆，桿
谷	谷，穀
刮	刮，颳
拐	拐，柺
哄	哄，鬨
后	后，後
糊	糊，餬
胡	胡，鬍，衚
哗	嘩，譁
划	划，劃
回	回，迴
汇	匯，彙
伙	伙，夥
获	獲，穫
几	几，幾
家	家，傢
奸	奸，姦
僵	僵，殭
姜	姜，薑
尽	盡，儘
径	徑，逕
据	据，據
卷	卷，捲
克	克，剋
扣	扣，釦
夸	夸，誇
昆	昆，崑
困	困，睏
了	了，瞭
累	累，纍
里	里，裡
历	歷，曆
栗	栗，慄
帘	帘，簾
卤	鹵，滷
仑	侖，崙
麻	麻，痲
蒙	蒙，濛，矇
弥	彌，瀰
面	面，麵
渺	渺，淼
蔑	蔑，衊
万	万，萬
你	你，妳
念	念，唸
匹	匹，疋
朴	朴，樸
仆	仆，僕
铺	鋪，舖
千	千，韆
签	簽，籤
秋	秋，鞦
曲	曲，麴
折	折，摺
舍	舍，捨
沈	沈，瀋
升	升，昇，陞
尸	尸，屍
松	松，鬆
苏	蘇，囌，甦
它	它，牠
他	他，祂
台	台，枱，颱
坛	壇，罈
同	同，衕
涂	涂，塗
团	團，糰
托	托，託
挽	挽，輓
喂	喂，餵
系	系，係，繫
咸	咸，鹹
向	向，嚮
幸	幸，倖
凶	凶，兇
须	須，鬚
吁	吁，籲
咽	咽，嚥
佣	佣，傭
游	游，遊
余	余，餘
逾	逾，踰
于	于，於
郁	郁，鬱
愈	愈，癒
御	禦，御
欲	欲，慾
岳	岳，嶽
芸	芸，蕓
云	云，雲
扎	扎，紮
赞	贊，讚
脏	臟，髒
占	占，佔
沾	沾，霑
征	征，徵
症	症，癥
只	只，隻
致	致，緻
志	志，誌
制	制，製
钟	鐘，鍾
周	周，週
注	注，註
准	准，準
斫	斫，斲
凄	淒，悽
沄	沄，澐
旋	旋，鏇
雕	雕，鵰
借	借，藉
扇	扇，搧
